010001011011
011011010001
000000111111111
1111110000000
010001011011
011011010001

111 111001000101
01000100110011011
0000000001000101
001000100000
011101110000
000000100000
1110
1010
1110

11111111100111111111111111111111111111111111111
11111111100000000000000000000000000000000000011
11000001100000000000000000000000000000000000011
11111111100000000000000000000000000000000000011
11111111100000000000000000000000000000000000011
00000000000000000000000000000000000000000000011
00000000000000000000000000000000000000000000011
00000000000000000000000000000000000000000000011
00000000000000000000000000000000000000000000011
00000000000000000000000000000000000000000000011
00000000000000000000000000000000000000000000011
00000000000000000000000000000000000000000000011
00000000000000000000000000000000000000000000011
00000000000000000000000000000000000000000000011
00000000000000000000000000000000000000000000011
00000000000000000000000000000000000000000000011
00000000000000000000000000000000000000000000011
00000000000000000000000000000000000000000000011
00000000000000000000000000000000000000000000011
00000000000000000000000000000000000000000000011
00000000000000000000000000000000000000000000011
00000000000000000000000000000000000000000000011
00000000000000000000000000000000000000000000011
00000000000000000000000000000000000000000000011
00000000000000000000000000000000000000000000011